source	gold	translation	BLEU score
Avizo a V Pte q Noticie aos inquizidores q eu tenho dado a alma ao diabo, e q dezespero e aRenego de Ds Padre de Ds filho, e de Deos espyrito Santo, e de qtos Santos tem o Ceo; e q somte venero, amo, e adoro a Lucifer por Senhor de minha vida, e alma:	Aviso a Vossa Paternidade que noticie aos inquisidores que eu tenho dado a alma ao diabo e que desespero e arrenego de Deus, padre de Deus Filho e de Deus Espírito Santo e de quantos santos tem o céu, e que somente venero, amo e adoro a Lúcifer por senhor de minha vida e alma.	Aviso os inquiridores que dei a alma ao diabo, e q desespero e aRenego de Deus Pai de Ds Filho, e de Deus Espírito Santo, e de qtos Santos tem o Céu; e q sou venerável, amo, e adoro Lúcifer por Senhor da minha vida, e alma:	16.896940988372965
e isto Repito, digo, e comfesso todos os instantes sem temor algũ desse Ds a qm athe gora Cegamte adorava pa meu mal;	E isto repito, digo e confesso todos os instantes, sem temor algum desse Deus, a quem até agora cegamente adorava para meu mal.	E isso eu repito, eu digo, e eu confesso todos os momentos sem medo de qualquer coisa desse Ds a quem o gora Cegamte adorava para o meu mal;	8.767682465879751
e porq desta mudança foy cauza o Pe Mel thomas, elle tenha o premio q dos infernaes spiritos espero	E porque desta mudança foi causa o padre Manuel Tomás, ele tenha o prémio que dos infernais espíritos espero.	E por causa dessa mudança, Pe. Mel Thomas, ela tem o prêmio dos espíritos infernais.	3.156106667546408
faso esta deliga por papel, porq a prizão me impozibilita pa a fazer eu proprio; e não Remeto as noticias a inquizidores algũ porq quero q seja V Pte obrigado a saber os Comfisados q tem, e a qm os emtrega; q infalivelmte me parese q está obrigado a dar pte deste cazo ao santo oficio,	Faço esta diligência por papel, porque a prisão me impossibilita para a fazer eu próprio, e não remeto as notícias a inquisidores algum porque quero que seja Vossa Paternidade obrigado a saber os confessados que tem e a quem os entrega; que infalivelmente me parece que está obrigado a dar parte deste caso ao Santo Ofício.	Se eu fizer esta delegação por papel, porque a prisão me impede de fazê-la eu próprio; e eu não envio as notícias a inquiridores, porque eu quero que seja V Pte obrigado a saber os Comfisados que você tem, e a quem eu os entrego; q infalivelmte me pareça que ele é obrigado a dar este caso ao santo ofício,	22.171731801137696
e qdo o não faça prontisimamte creminarei a V Pte por consentidor das indozlencias com q o Pe Mel Thomas machado domina a Caza de Mariana da Silva, sem o atemorizar a Vista de Coatro Clerigos q por semelhantes Couzas Sahirão este a-cto de fé.	E, quando o não faça prontissimamente, criminarei a Vossa Paternidade por consentidor das indulgências com que o padre Manuel Tomás Machado domina a casa de Mariana da Silva, sem o atemorizar à vista de quatro clérigos que, por semelhantes coisas, saíram este ato de fé.	E quando eu não estiver pronto, vou cremar você por consentir com a indolência com a qual o Pe. Mel Thomas machado domina a Caça de Mariana da Silva, sem ter medo da Vista de Quatro Clérigos q por semelhantes Couzas Sahirão este ato de fé.	19.82009848990766
Não Repare na dezordem da escripta, q a pena com q fico não dá mais lugar q sertificarlhe q qqm dis isto he	Não repare na desordem da escrita, que a pena com que fico não dá mais lugar que certificar-lhe que quem diz isto é,	Não olhe para o desordenamento da escrita, q a pena com q fico não dá mais lugar q lhe sertificar qqqm digo isto he	24.192619393259786
Antonio da Cruz e Silva	António da Cruz e Silva	Antonio da Cruz e Silva	66.87403049764218
Meu padrinho e mto meu Snor	Meu Padrinho e muito meu Senhor.	Meu padrinho e meu snor.	9.71654721818804
q Vm Logre saude	Que VM logre saúde.	q Vm Logre saude	0.0
mto filis o estimarei Como quem a todos Vmces [...] he tão obrigada e devedora pella grandioza esmola q Vmces fizerão a Meu Irmão e pellos continos favores que de Vmces sempre resebemos	Muito feliz o estimarei, como quem a todos VMs é tão obrigada e devedora pela grandiosa esmola que VMs fizeram a meu irmão e pelos contínuos favores que de VMs sempre recebemos.	Mto filis o estimarei Como quem a todos Vmces... tenho tão obrigada e devedora pela grandiosidade da esmola que Vmces farão ao Meu Irmão e pelos contínuos favores que de Vmces sempre recebemos	30.200280724298825
tudo seja pello amor de Ds	Tudo seja pelo amor de Deus.	tudo seja pello amor de Ds	15.207218222740094
Meu padrinho e Snor hũa aflissão em q me vejo me obriga a fazer esta obrigada de meus confesores	Meu padrinho e Senhor, uma aflição em que me vejo me obriga a fazer esta, obrigada de meus confessores.	Meu padrinho e Snor aflição em que me vejo me obriga a fazer esta obrigação de meus confessores	53.43149081986374
sabera Vm em Como eu estive no Convento da esperanssa de Abrantes	Saberá VM em como eu estive no Convento da Esperança, de Abrantes.	Você saberá em Como estive no Convento da Esperança de Abrantes	31.763442542283983
e estando na Conpanhia de duas freiras estas tais tendo notisia q lhe mudarão dali o Capellão e sendo suas particulares amigas so juntarao Com outras duas religiozas e fiandosse mim fizerão huma pineira pra saberem se o Capellão havia de ficar ou não	E, estando na companhia de duas freiras, estas tais, tendo notícia que lhe mudaram dali o capelão e sendo suas particulares amigas, se juntaram com outras duas religiosas e, fiando-se mim, fizeram uma peneira para saberem se o capelão havia de ficar ou não.	e estando na Companhia de duas freiras estas tais tendo notícia q lhe mudarão de lá o Capelão e sendo suas particulares amigas só o juntarão com outras duas religiosas e, confiando em mim, farão uma bagunça para saber se o Capelão deveria ficar ou não	25.641178616682293
eu confesso q fui buscar a pineira e quis asistir pa ver Como se voltava a pineira e sem lhe bolirem q hera o sinal q dava pa dizer sim o não	Eu confesso que fui buscar a peneira e quis assistir, para ver como se voltava a peneira e sem lhe bulirem, que era o sinal que dava para dizer sim ou não.	Eu confesso que fui buscar a bagunça e quis assistir para ver como se voltava a bagunça e sem bolirem q havia o sinal q dava para dizer sim o não	39.69538148006036
mas não vi com medo de q me não quizesem asolver	Mas não vi, com medo de que me não quisessem absolver.	Mas não vi com medo de que eu não quisesse resolver.	30.039183588157954
as q nesta ocasião a fizerão são as seguintes Me dona Ma madalena dona he a qual he agora abadessa e a Me Antonia Ma e a Me Catherina dos Saraphns e a Me violante Ma de jasus	As que nesta ocasião a fizeram são as seguintes: Madre Dona Maria Madalena, dona e a qual é agora abadessa, e a Madre Antónia Maria e a Madre Catarina dos Sarafins e a Madre Violante Maria de Jesus.	as que nesta ocasião a farão são as seguintes Me dona Madalena dona he a qual tenho agora abadessa e Me Antonia Ma e Me Catherina dos Saraphns e Me violante Ma de jasus	10.729015699214745
estas são q eu sei q a fizerão mas suponho não continuam	Estas são que eu sei que a fizeram, mas suponho não continuam.	Estas são q eu sei q farão, mas suponho que não continuem.	16.98619749062629
e isto havera dois annos pouco mais e menos	E isto haverá dois anos, pouco mais e menos.	E isso terá dois anos, pouco mais e menos.	69.89307622784945
tambem A Me Joanna Catherina do mesmo Convento se gabou q a fizera	Também a Madre Joana Catarina, do mesmo convento, se gabou que a fizera.	Joanna Catherina, do mesmo convento, também se gabou de tê-la feito.	27.40623717328051
e eu Snor padrinho, tenho prezunssão de q mtas tem feito isto	E eu, Senhor Padrinho, tenho presunção de que muitas tem feito isto.	E eu, Snor padrinho, tenho a presunção de que você tem feito isso.	19.71584187923815
asim pesso a Vm pello amor de Ds q se governe isto no milhor modo q puder ser e pa q eu fique descanssada de q Vm esta entregue desta	Assim, peço a VM, pelo amor de Deus, que se governe isto no melhor modo que puder ser e para que eu fique descansada de que VM está entregue desta.	Assim, pese a você, o amor de Deus, q isso seja governado da melhor maneira que possa ser, e eu fico descansada de que você está entregue a esta.	13.759957472907214
espero q Vm me Responda Remetendo a Resposta a Snra dona Lionor minha Snra	Espero que VM me responda, remetendo a resposta à Senhora Dona Leonor, minha Senhora.	Espero que me responda remetendo a resposta para Sna. Dona Lionor, minha Sna.	14.880554366907562
eu fico pedindo a Ds gde a Vm mtos anos	Eu fico pedindo a Deus guarde a VM muitos anos.	Eu estou pedindo a Deus por muitos anos.	24.839003933972585
Sardoal dezasseis de marso mil e setesentos e vinte e dois	Sardoal, dezasseis de março, mil e setecentos e vinte e dois	Sardoal dezesseis de março mil e sessenta e vinte e dois	27.22179122549562
de Vm Afilhada e menor Criada	De VM afilhada e menor criada,	de Vm Afilhada e Menor Criada	6.870636427700047
Joanna da Me de Ds	Joana da Madre de Deus	Joanna da Me de Ds	12.703318703865365
Meo amo e Sr	Meu Amigo e Senhor,	Meo amo e Sr.	10.682175159905848
Ainda q VM me não quer dar o alivio de suas novas a minha amizade não pide tal discuido e assi lembresse VM de mim [...] com novas suas q bem sabe q não tem qm lhas dezeje com mais veras	ainda que VM me não quer dar o alívio de suas novas, a minha amizade não pide tal descuido e, assim, lembre-se VM de mim com novas suas, que bem sabe que não tem quem lhas deseje com mais veras.	Ainda que a VM não queira me dar o alívio de suas notícias, minha amizade não pede tal discussão e assim lembre a VM de mim [...] com novas suas q bem sabe q não tem q as deseje com mais verdades	19.409941270556097
Sabado nove deste mes Domingos de Moraes Clerigo em minoribus nal de Vinhais veyo a esta casa e entre praticas q tivemos me dice, q hũ Rapaz chamado Sebam filho do Capam Franco Roiz da ditta va de Venhais perguntara a hũ Rapaz pequeno filho de Manoel Roiz Cané Christão Novo q fazião as noites em sua casa;	Sábado, nove deste mês, Domingos de Morais, clérigo em minoribus, natural de Vinhais, veio a esta casa e entre práticas que tivemos me disse que um rapaz chamado Sebastião, filho do capelão Francisco Rodrigues da dita vila de Vinhais, perguntara a um rapaz pequeno, filho de Manuel Rodrigues Cané, cristão-novo, que faziam às noites em sua casa.	Sábado 9 deste mês, Domingos de Moraes Clerigo em minoribus nal de Vinhais vejo esta casa e entre as práticas que tivemos me diz, qhhh Rapaz chamado Sebam filho do Capam Franco Roiz da ditta vai de Venides havia perguntado a h Rapaz pequeno filho de Manoel Roiz Cané Christão Novo que fazem as noites em sua casa;	19.03302174179992
[...] o tal Rapaz Respondera, q seu pay dizia Missa, [...] Manoel Roiz Pechuga de alcunha christão novo lhe ajudava, e q Pascoal Ramos tãobem christão novo q tomava sobrepeliz, e q ao dito Rapaz o punhão sobre o altar, e q sua May asoutava hũ santo christo com hua corda	[...] O tal rapaz respondera que seu pai dizia missa, [...] Manuel Rodrigues, Pechuga de alcunha, cristão-novo, lhe ajudava e que Pascoal Ramos, também cristão-novo, que tomava sobrepeliz, e que ao dito rapaz o punham sobre o altar e que sua mãe açoutava um santo Cristo com uma corda.	O tal Rapaz tinha respondido, q seu pay dizia Missa,... Manoel Roiz Peitoga de apelido cristão novo o ajudava, e q Pascal Ramos tão novo que tomava sobrepeliz, e q ao dito Rapaz o punho sobre o altar, e q sua May asountava h santo Cristo com hua corda	12.90386090820487
E no mesmo dia de tarde veyo tãobem a minha casa o pe gco Frco de Amal nal de Vinhais e perguntandolhe eu pello sobredito me Respondeo, q era tanto verde, q dizendolhe tres Mulheres o Referido prendera o Rapaz em sua casa, e lhe confessara tudo o narrado,	E no mesmo dia de tarde veio também a minha casa o padre Gonçalo Francisco de Amaral, natural de Vinhais, e, perguntando-lhe eu pelo sobredito, me respondeu que era tanto verdade, que, dizendo-lhe três mulheres o referido, prendera o rapaz em sua casa e lhe confessara tudo o narrado.	E no mesmo dia da tarde vejo também em minha casa o pe gco Frco de Amal nal de Vinhais e perguntando-lhe eu pello sobredito me respondo, q era tão verde, q dizendo-lhe três Mulheres o Referido havia prendido o Rapaz em sua casa, e lhe havia confessado tudo o narrado,	12.59194438923224
e supposto q disto se terá dado pte eu o faço a VM por não ficar com escrupello	E, suposto que disto se terá dado parte, eu o faço a VM por não ficar com escrúpulo.	E suponho que isso se deu para que eu faça a VM por não ficar com escrúpulo.	36.43212929021357
aqui fico ás ordens de VM pa o q me quizer mandar com gde vontade	Aqui fico às ordens de VM para o que me quiser mandar com grande vontade.	aqui estou às ordens da VM para o q quer me enviar com prazer	12.534122247249353
Ds gde a VM	Deus guarde a VM.	Ds gde para VM	12.44023474812678
Prada 10 de Julho de 1712	Prada, 10 de julho de 1712	Prada 10 de julho de 1712	67.31821382417488
Mayor Amo e Servidor de VM	Maior amigo e servidor de VM,	Maior Mestre e Servidor VM	9.423716574733431
Franco de SáMzes	Francisco de Menezes	Franco de SáMzes	27.516060407455225
Meu filho todo do meu Coracão	Meu filho todo do meu coração.	Meu filho todo do meu Coração	64.31870218238025
não te poso expeLicar o sentimento Com que estou por tu te hires emvora mas Como tenho a Serteza que tu veis Logo por iso me fica aLguma ConsoLacão	Não te posso explicar o sentimento com que estou por tu te ires embora, mas, como tenho a certeza que tu vens logo, por isso me fica alguma consolação.	Não posso expor o sentimento com que estou por você, mas como tenho a Serte que você vê logo por isso me fico com algum Consolo.	24.159901115663644
tu bem saves que eu não tenho a nimgem senão a ti e so a ti he que amo e so a ti he que quero pois so tu hes o meu amor	Tu bem sabes que eu não tenho a ninguém senão a ti e só a ti é que amo e só a ti é que quero, pois só tu és o meu amor.	Você bem sabe que eu não tenho a ningem senão a você e só a você eu amo e só a você eu quero pois só você é meu amor	24.39358245867743
agora baste emvora eu fico So e Com mtas saudades do meu menino	Agora vais-te embora, eu fico só e com muitas saudades do meu menino.	Agora basta, eu fico só e com saudades do meu menino.	58.73934418709088
olha se por La me podes perder o amor pois eu te sou firme e hei de Ser e se Cuidas houtra couza inganaste pois tu ainda não saves bem o Coanto eu te quero	Olha se por lá me podes perder o amor, pois eu te sou firme e hei de ser e, se cuidas outra coisa, enganas-te, pois tu ainda não sabes bem o quanto eu te quero.	Olha se por La podes perder o amor porque eu te sou firme e hei de Ser e se Cuidas outra couça enganaste porque ainda não sabe bem o que eu te amo	27.372797031904238
adeos meu rico marido	Adeus, meu rico marido.	Adeus, meu rico marido.	100.00000000000004
pasa bem por La que eu aqui fico sentindo esta auzensia pa mim tam Custoza	Passa bem por lá, que eu aqui fico sentindo esta ausência para mim tão custosa.	É bom que eu fique aqui sentindo essa ausência para mim, tão Custoza.	12.802091018942972
aseita agora mtas saudades do teu Coninho que fica Com mtas saudades do seu menino	Aceita agora muitas saudades do teu coninho, que fica com muitas saudades do seu menino.	Agora sente saudades do seu Cone que sente saudades do seu menino	17.273759252522485
as tuas maminhas tambem te mandam mtos abrasos e adeos meu menino emthe a bista pois dezejarei Seja Logo pa meu aLivio	As tuas maminhas também te mandam muitos abraços e adeus, meu menino, até à vista, pois desejarei seja logo para meu alívio.	Suas mamãs também te mandam medos abrasados e adeus meu menino, pois desejarei Seja logo para meu aLivio	15.493587232115322
adeos	Adeus.	adeus	0.0
aseita desta tua molher mtos abrasos e mtos beiginhos	Aceita desta tua mulher muitos abraços e muitos beijinhos.	Seus pés molhados e beijinhos.	9.22364410103253
Desta que deveras te quer e ama emthe a morte	Desta que deveras te quer e ama até à morte,	Desta que deveras te ama e ama até a morte	35.54333944875169
Meu Marido todo o meu bem	Meu Marido, todo o meu bem.	Meu marido todo o meu bem	38.49815007763549
não te poso expeliCar as lagrimas que Choro Com saudades tuas pois me parese que ha hum anno que te não bi	Não te posso explicar as lágrimas que choro com saudades tuas, pois me parece que há um ano que te não vi.	Eu não posso expulsar as lágrimas que eu choro com sua saudade, pois eu acho que há um ano que eu não vi você.	23.804003814061673
em Cegundo lugar desejarei esta te aChe Com saude pois he o que mais te desejo	Em segundo lugar, desejarei esta te ache com saúde pois é o que mais te desejo.	Em segundo lugar desejarei esta aChe Com saude pois tenho o que mais te desejo	30.317983229357157
eu fiCo boa pa te dar gosto	Eu fico boa, para te dar gosto.	Fico muito bem para te dar gosto.	45.62272070865922
meu filho Ca resevi a fita	Meu filho, cá recebi a fita.	meu filho Ca reseguei a fita	12.872632311973014
pois te Comfeso que o estimei mto mas mto mais a havia de estimar se fose mto mais pois intam Conhesia que tu tinhas siumes de mim	Pois te confesso que o estimei muito, mas muito mais a havia de estimar, se fosse muito mais, pois então conhecia que tu tinhas ciúmes de mim.	Porque eu te confessei que eu o estimava, mas eu a estimaria mais se fosse mais, porque eu sabia que você tinha seme de mim.	8.39687092332072
mas Como ma mandastes bermelha he serto que estas em guera Comigo	Mas, como ma mandastes vermelha, é certo que estás em guerra comigo.	Mas como você me mandou vermelha, eu sinto que você está em guerra comigo.	20.14941615706457
tu bem saves que eu sou mto tua e que não amo a mais nimgem senão a ti pois so tu hes o meu bem e todo o meu amor	Tu bem sabes que eu sou muito tua e que não amo a mais ninguém senão a ti, pois só tu és o meu bem e todo o meu amor.	Você sabe bem que eu sou sua e que não amo mais ninguém senão você, pois só você é meu bem e todo meu amor.	27.01281433424456
meu menino quem me dera ja berte pa te dar mtos abrasos e mtos beiginhos e meterte a linguinha toda nesa boquinha	Meu menino, quem me dera já ver-te para te dar muitos abraços e muitos beijinhos e meter-te a linguinha toda nessa boquinha.	Meu menino, quem me dera te berrar para te dar medos ardentes e metos beijinhos e te enfiar toda a língua nessa bocazinha.	28.20004915753772
as tuas maminhas todas tuas e de mais nimgem não so sam tuas e tudo Coanto he meu he so pa o meu marido pois so a ele quero e so a ele amo	As tuas maminhas, todas tuas e de mais ninguém não, só são tuas e tudo quanto é meu é só para o meu marido, pois só a ele quero e só a ele amo.	Suas mamas são todas suas e de mais ninguém não são suas e tudo Quanto mais eu sou meu pai meu marido porque só ele amo e só ele amo	14.581637979821593
vejo o que me dizes que te diseram que eu tinha alugado humas Cazas e tambem do torto de ponte	Vejo o que me dizes que te disseram: que eu tinha alugado umas casas e também do Torto de Ponte.	Vejo o que me diz que lhe disseram que aluguei umas caças e também do torto de ponte.	18.27204210739146
saveras que tudo he huma pouCa de mentira pois eu não sou Capas de te inganar	Saberás que tudo é uma pouca de mentira, pois eu não sou capaz de te enganar.	Você sabe que tudo é uma mentira, porque eu não sou capaz de enganá-lo.	37.60392305513499
e te digo que tudo he mentira isto o podes querer Como tua molher que sou	E te digo que tudo é mentira – isto o podes crer – como tua mulher que sou!	E eu te digo que tudo eu menti isso você pode querer como sua esposa que eu sou	15.125149328637187
não te fies [...] em quem me quer mal pois te dezega dizer Couzas pa que tu não tornes a falar Comigo nem querem que tu mandes nada	Não te fies em quem me quer mal, pois te deseja dizer coisas para que tu não tornes a falar comigo, nem querem que tu mandes nada.	Não confie... em quem me quer mal, pois te deixa dizer Couzas para que você não volte a falar Comigo, nem querem que você mande nada.	35.102919644866816
vejo o que me dizes que neste Coreio me mandas huns sapatos bonitos	Vejo o que me dizes, que neste correio me mandas uns sapatos bonitos.	Vejo o que me diz que neste Coréia me manda sapatos bonitos.	27.43937845663834
eu hei de estimar mto por serem da tua mam	Eu hei de estimar muito, por serem da tua mão.	Eu vou amar-me por ser da sua mãe.	4.8312524369621626
tambem vejo o que me dizes que me queres mandar os pratos e as mais Cozas	Também vejo o que me dizes, que me queres mandar os pratos e as mais cousas.	Também vejo o que me diz que quer me mandar os pratos e as Coças.	43.14730529010987
Rec reComendo oo home da lanCha que não de iso senão a preta ou [...] a mim	Recomenda ao homem da lancha que não dê isso senão à preta ou [...] a mim.	Rec Recomendo o homem da lancha que não dele senão a preta ou [...] a mim	56.42864776886819
que não soseda Como da outra bes	Que não suceda como da outra vez.	que não sossegue Como da outra vez	22.772101321113862
tu reComenda tambem ao Coreio que não de a Carta senão a preta	Tu recomenda também ao correio que não dê a carta senão à preta.	Você também recomenda ao Coréio que não dê a Carta senão a preta	21.931172519140546
adeos meu filho	Adeus, meu filho.	Adeus, meu filho.	100.00000000000004
adeos meus amores	Adeus, meus amores.	Adeus meus amores	32.34325178227722
aseita mtos abrasinhos as tuas maminhas e da tua boquinha perninhas pentilhinho e do teu Coninho que esta tam goardadinho so pa o meu Rico marido todo do meu CoraCão	Aceita muitos abracinhos das tuas maminhas e da tua boquinha, perninhas, pentelhinho e do teu coninho, que está tão guardadinho só para o meu rico marido, todo do meu coração.	Cozinhe suas mamilas e suas pernas pequenas, e seu Conezinho, que é tão pequeno só para meu marido rico, todo o meu Coração.	4.908745991473103
adeos meu filho	Adeus, meu filho.	Adeus, meu filho.	100.00000000000004
toma hum beiginho e hum abrasinho que to manda a tua molher	Toma um beijinho e um abracinho que to manda a tua mulher.	Pegue um beijinho e um abraço que manda sua molhada	21.53672420052281
Desta que tam deveras te ama e ha de amar a tua	Desta que tão deveras te ama e há de amar, a tua	Desta que ele realmente te ama e tem que amar a sua.	15.727800941615351
Maria gabriela	Maria Gabriela	Maria Gabriela	100.00000000000004
J M J	Jesus Maria José	J M J	0.0
M amado Sr	Muito amado senhor	M amado Sr.	15.97357760615681
Custo, saude e paz em o sor	Custódio, saúde e paz em o Senhor.	Custo, saúde e paz no soro	30.895757752065425
sendome precizo chegar a esta caza aonde me dizem q VM estivera, senti m não o achar nella, porq tinha q lhe com-unicar materias de importancia;	Sendo-me preciso chegar a esta casa onde me dizem que VM estivera, senti muito não o achar nela, porque tinha que lhe comunicar matérias de importância.	Sendo preciso chegar a esta caçada onde me dizem que VM esteve, senti que não o achava nela, porque tinha que lhe comunicar matérias de importância;	55.43226672204016
mas suposta a sua retirada terei por hora pa-ciencia;	Mas, suposta a sua retirada, terei por ora paciência.	mas suposta sua retirada terei por hora paciência;	10.693319442988287
e só se me offerece dizerlhe por letra, q em Beja se espera q VM vá pregar hũa quaresma q lá lhe está aceita na boa fé de q não tinha nisso duvida;	E só se me oferece dizer-lhe por letra que em Beja se espera que VM vá pregar uma quaresma que lá lhe está aceite, na boa fé de que não tinha nisso dúvida.	e só se me oferece dizer por letra, q em Beja se espera que VM vá pregar ha quaresma q lá lhe é aceita na boa fé de q não tinha nisto dúvida;	38.63552232164503
e assim espero q não falte a isto, e despois, da-lo q por Mis-sionar ali o Pe Fr Afonso, não tenha VM lu-gar de fazer logo o mesmo como estava deter-minado;	E, assim, espero que não falte a isto e, depois, dá-lo que, por missionar ali o padre frei Afonso, não tenha VM lugar de fazer logo o mesmo como estava determinado.	e assim espero que não falte a isso, e depois, dando-o por Missionar ali o Pe. Fr. Afonso, não tenha VM-gar de fazer logo o mesmo como estava determinado;	37.91980012340694
bem sabe q em Moura me empenhou o Vigo da vara com toda a instancia pa q lhe desse missão áquella terra;	Bem sabe que em Moura me empenhou o vigário da vara com toda a instância, para que lhe desse missão àquela terra.	Bem sabe que em Moura me empenhou o Vigo da vara com toda a instância para lhe dar missão àquela terra;	55.176400789681395
e assim fio do seu zelo, q não faltará a isto, satisfazendo primo á quaresma q roca á Beja;	E, assim, fio do seu zelo, que não faltará a isto, satisfazendo primeiro a quaresma que roca a Beja.	e assim fio do seu zelo, q não faltará a isto, satisfazendo primo à quaresma q rocha à Beja;	36.351466652457695
porq aliás, sera m sensivel ali a sua falta, e eu mais q ninguẽ o sentirei;	Porque, aliás, será muito sensível ali a sua falta, e eu mais que ninguém o sentirei.	Porque, aliás, será mais sensível à sua falta, e eu mais ninguém o sentirei;	48.994561421713136
o q não prezumo, não só pela pontu-alide, com q VM obra no q o Prelado lhe ordena, mas tambem porq estou certo de q não se esqueçe do qto o meu affecto lhe merece;	O que não presumo, não só pela pontualidade com que VM obra no que o prelado lhe ordena, mas também porque estou certo de que não se esquece do quanto o meu afeto lhe merece.	o q não pressumo, não só pelo ponto-alide, com q VM obra no que o Prelado lhe ordena, mas também porque tenho certeza de que não se esqueça do q o meu afeto lhe merece;	39.62613282822654
á cuja pessoa Ds gde	A cuja pessoa Deus guarde.	a cuja pessoa Ds gde	17.491650626361256
Evora em 12 de Fevero de 1749	Évora, em 12 de fevereiro de 1749.	Evora em 12 de Fevereiro de 1749	23.099966849728546
Teu ir e servo affectuozisso	Teu irmão e servo afetuosíssimo,	Você é um servo afetuoso.	8.116697886877475
Fr Jozé do Redo Vigo Proval	frei José do Redo, vigário provincial	Jozé do Redo Vigo Proval	14.320952289897704
Ma Sra D Tomazia Izabel Gonzaga	Minha Senhora Dona Tomásia Isabel Gonzaga.	Sra. D Tomazia Izabel Gonzaga	8.170609724417774
Aos pes de Vmce me chego, ainda q com pouco conhecimto, sempre animado por ser sra, cujas prendas tendo ouvido louvar mto, e por ser filha de outra sra a qm em N Sr amo, qto não sei explicar.	Aos pés de VM me chego, ainda que com pouco conhecimento, sempre animado por ser Senhora cujas prendas tenho ouvido louvar muito e por ser filha de outra senhora a quem em Nosso Senhor amo, quanto, não sei explicar.	Aos pés de Vmce chego, ainda com pouco conhecido, sempre animado por ser sra., cujos presentes tendo ouvido louvar mto, e por ser filha de outra sra. a qm em N Sr. amo, qto não sei explicar.	31.306306182567468
Não ha couza neste mũdo, q não tenha remedio:	Não há coisa neste mundo que não tenha remédio.	Não há coxa neste modo, q não tenha remédio:	18.36028134946796
não ha mal q sempre dure:	Não há mal que sempre dure.	Não tem mal q sempre dure:	15.619699684601283
confeço, e estou mto bem informa-do [...] do mto q nesa caza padece.	Confesso, e estou muito bem informado, [...] do muito que nessa casa padece.	Confesso, e estou bem informado... do que sofre nessa caçada.	20.830666398386118
eu o sei mto bem de verde,	Eu o sei muito bem de verdade.	Eu sei muito bem de verde.	39.44243648327556
e sinceramte lhe confeço, q a ser ja conveniente, eu mesmo fora, qm com a sra sua Mai, fizera tod as deligas pa dahi a tirar.	E sinceramente lhe confesso que, a ser já conveniente, eu mesmo fora quem, com a Senhora sua mãe, fizera todas as diligências para daí a tirar.	E sinceramente confesso, que a ser já conveniente, eu mesmo fora, com a sua Sra. Mai, tinha feito todas as deligas pa daí a tirar.	39.370734300145664
porem tudo tem seu tempo,	Porém, tudo tem seu tempo.	Mas tudo tem seu tempo.	64.31870218238025
e rezoluçoens apre-sadas são precipicio certo.	E resoluções apressadas são precipício certo.	e resoluções apressadas são precipitação certa.	26.269098944241588
Veja q em hũ peito nobre, como o seu, não dizem bem vilanias, e menos lhe estão bem inconsiderações.	Veja que em um peito nobre como o seu não dizem bem vilanias, e menos lhe estão bem inconsiderações.	Veja q em h peito nobre, como o seu, não dizem bem vilões, e menos lhe estão bem desconsiderados.	34.64020111658723
Disfarçar he bizar-ria, e generozide de animo.	Disfarçar é bizarria e generosidade de ânimo.	Disfarçar-me-ei de bizarro e generoso de ânimo.	22.089591134157878
Desfarce por hũ pouco, coma, disimule, q Ds he grde,	Disfarce por um pouco, coma, dissimule, que Deus é grande.	Desfazer por pouco tempo, coma, dissimule, q Ds he grde,	28.917849332325716
entretãto se podem dar ordem aos meyos pa o seu alivio.	Entretanto, se podem dar ordem aos meios para o seu alívio.	Se puderem dar ordens aos meios para o seu alívio.	49.19533018641346
A mim me tem, pa qto lhe poder servir com aquela vonte, q em seu mesmo Pai experimentaria.	A mim, me tem para quanto lhe puder servir, com aquela vontade que em seu mesmo pai experimentaria.	Ele tem a mim, para poder servi-lo com aquela vadia, q em seu mesmo Pai experimentaria.	12.061917467741438
Não desdoure com açoens de hũ dia o credito, e louvores, q com a sua nobreza, e bela indole toda vida tem grangeado.	Não desdoure com ações de um dia o crédito e louvores, que com a sua nobreza e bela índole toda vida tem granjeado.	Não desdobre com açoens de hoje o crédito, e louvores, q com sua nobreza, e bela índole toda vida tem feito.	29.910668983633368
Pondere a suprema, e infinita Mage de Ds S N, q creou a vmce aos Anjos, a todo mũdo irado contra vmce, q pode tomar vingança das injurias, q vmce a sua mesma Mai está fazendo, q Ds toma por seus os agravos feitos a Mays.	Pondere a suprema e infinita majestade de Deus Senhor Nosso que criou a VM, aos Anjos, a todo mundo irado contra VM, que pode tomar vingança das injúrias que VM a sua mesma mãe está fazendo, que Deus toma por seus os agravos feitos a mães.	Considere a suprema e infinita Mage de Ds S N, q criou a vmce aos Anjos, a todo o modo irado contra vmce, q pode tomar vingança das injúrias, q vmce sua própria Mai está fazendo, q Ds toma por seus os agravos feitos a Mays.	34.047955911039296
Espero de vmce, e do seu generozo animo me não falte, ao q lhe peço prostrado a seus pes,	Espero de VM e do seu generoso ânimo me não falte ao que lhe peço prostrado a seus pés.	Espero de vmce, e do seu generoso ânimo não me falte, ao que peço prostrado a seus pés,	41.05312217049157
e vem a ser, q coma, q de gloria a Ds; confuzão a satanas, e espere hũ pouco, q Ds descubra meyos eta de se ver livre desa caza.	E vem a ser que coma, que dê glória a Deus, confusão a Satanás, e espere um pouco que Deus descubra meios, etc, de se ver livre dessa casa.	e vem a ser, q coma, q de glória a Ds; confusão a satanás, e espere um pouco, que Ds descubra como se livrar dessa caçada.	19.34885758625304
Meu Pai.	Meu Pai.	Meu pai.	34.66806371753173
Da boca do Rio escrevo esta a Vmce pa lhe dizer q chegando nós a ella, topamos essas Cartas do Pe Penha, e logo da outra banda ao Sergio com tudo o q havia na Fazenda.	Da boca do rio escrevo esta a VM para lhe dizer que, chegando nós a ela, topámos essas cartas do padre Penha e, logo da outra banda, ao Sérgio, com tudo o que havia na fazenda.	Da boca do Rio escrevo esta a Vmce para dizer-lhe q chegando nós a ela, encontramos essas Cartas do Pe Penha, e logo da outra banda ao Sergio com tudo o que havia na Fazenda.	32.63708059620614
O Juiz lhe mandou em hũa Canoinha intimar a Portaria de S Excia e se Cazo elle não quizesse obedecer lhe dessem a vox de prezo.	O juiz lhe mandou em uma canoinha intimar à portaria de Sua Excelência e, se caso ele não quisesse obedecer, lhe dessem a voz de preso.	O Juiz mandou-lhe em ha Canoinha intimar a Portaria de S. Excia e se Cazo ela não quisesse obedecer lhe dariam a vox de preço.	6.921397405603303
Elle foi tão insolente q não quis obedecer a nada, e tão pouco Christão q vendo se allagava a Canoinha nem ao menos quis acudir a gente, de forma q morreu afogado hũ pobre mosso chamado Gabriel, q tinha hido fazer a deligencia	Ele foi tão insolente que não quis obedecer a nada e tão pouco cristão que, vendo se alagava a canoinha, nem ao menos quis acudir a gente, de forma que morreu afogado um pobre moço chamado Gabriel que tinha ido fazer a diligência.	Elle foi tão insolente q não quis obedecer a nada, e tão pouco Christão q vendo se inundava a Canoinha nem ao menos quis ir a nós, de forma q morreu afogado h pobre mosso chamado Gabriel, q tinha feito a deligência	22.976057980690936
Elle leva tudo sem dar fiança, aRancou taxas, e destruhio tudo.	Ele leva tudo sem dar fiança, arrancou taxas e destruiu tudo.	Elle leva tudo sem fiança, cobra taxas, e destruiu tudo.	32.00286101270288
Em-fim fica tudo acabado.	Enfim, fica tudo acabado.	No fim, está tudo acabado.	26.269098944241588
Por essa attestação de Retratação verá vmce o que fes Franc Aranha por induçoens de Jozé da Sa Contra D Quiteria	Por essa atestação de retratação, verá VM o que fez Francisco Aranha por induções de José da Silva contra Dona Quitéria.	Por esse atestado de retratação você verá o que Franc Aranha faz por induções de Jozé de Sa Contra D Quiteria.	10.110173740732797
Sergio aRancou da mão do homem a petição qdo lha foi intimar,	Sérgio arrancou da mão do homem a petição quando lha foi intimar.	Sergio arrancou da mão do homem a petição que lhe foi intimada,	48.63383168079942
emfim Se S Excia não acudir a isto com pronto Remedio bem se pode consider tudo acabado.	Enfim, se Sua Excelência não acudir a isto com pronto remédio, bem se pode considerar tudo acabado.	Enfim, se S. Excia não recorrer a isto com pronto Remédio bem se pode considerar tudo acabado.	48.81010344921758
Elle dis q se lhe não dá de ordens de S Excia	Ele diz que se lhe não dá de ordens de Sua Excelência.	Elle diz que não dá ordens de S. Excia.	11.24963413714218
Nós temos tido boa viajem, e já estamos livres de todo o perigo e até amenhã estamos em Caza.	Nós temos tido boa viagem e já estamos livres de todo o perigo e até amanhã estamos em casa.	Tivemos boa viagem, e já estamos livres de todo perigo e até amanhã estamos em Caça.	51.27942962306982
Mandeme por este Portador as me-ias pretas.	Mande-me por este portador as meias pretas.	Envie-me as minhas pretas por este Portador.	13.888095170058955
Lembrcas a todos eta	Lembranças a todos, etc.	Lembra-se de todos, eta.	17.965205598154213
Ds Ge a Vmce eta	Deus guarde a VM, etc.	Ds Ge a Vmce	7.545383788761362
Fo obde	Filho obediente,	Fo obde	0.0
Miguel	Miguel	Miguel	100.00000000000004
Mto Rdo Pe e Snr	Muito reverendo padre e senhor.	Mto Rdo Pe e Snr	8.745825313180626
Resebo a sua carta a qual me perdoe mas visto não serem os seus remedios ificazes pa a minha salvação pois so como sabe me salvaria não tem mais resposta q dizerlhe como me acho q suponho ficara satisfeito pois he o q podião esperar de semilhante negação demora e emganos com q tem Vmces tratado a minha alma	Recebo a sua carta, a qual, me perdoe mas, visto não serem os seus remédios eficazes para a minha salvação, pois só como sabe me salvaria, não tem mais resposta que dizer-lhe como me acho, que suponho ficará satisfeito, pois é o que podiam esperar de semelhante negação, demora e enganos com que têm VMs tratado a minha alma.	Recebo sua carta que me perdoa, mas visto que não são seus remédios eficazes para minha salvação, pois só como sabe me salvaria não tem mais resposta q lhe dizer como acho que ficaria satisfeito, pois tenho o q pode esperar de semi-negação demora e enganos com q tem Vmces tratado minha alma.	28.5668609889914
e como nem Ds nem a sua igreja e menistros podem valerme eu por ultima rezelucão digo a Vmce q renego de Ds; da sua may da trindade seus misterios sacramtos de tudo o q eles comtem como nulo e totalmte errado, por experiençia minha pois não tem poder	E, como nem Deus nem a sua igreja e ministros podem valer-me, eu por última resolução digo a VM que renego de Deus, da sua Mãe, da Trindade seus mistérios, sacramentos, de tudo o que eles contêm como nulo e totalmente errado, por experiência minha, pois não têm poder.	e como nem Ds nem sua igreja e ministros podem me valer por última vez digo a Vmce q renego de Ds; de sua may da trindade seus mistérios sacramtos de tudo o que eles contam como nulo e totalmte errado, por experiência minha pois não tem poder	24.97765304815034
e de todo me emtrego ao demonio a quem so conheso por poderozo cuja he e a de ser sempre a minha comfição; e comunhão o q digo, e comfirmo mto em meu juizo perfeito,	E de todo me entrego ao demónio, a quem só conheço por poderoso, cuja é e há de ser sempre a minha confissão e comunhão, o que digo, e confirmo muito em meu juízo perfeito.	e de tudo me entrego ao demônio a quem sou conhecido por poder cuja eu tenho e a de ser sempre minha concepção; e comunhão o que digo, e confirmo mto em meu juízo perfeito,	27.271804425850796
e nada mais tem lugar pelo q portesto ja lhe não dar emfados	E nada mais tem lugar, pelo que protesto já lhe não dar enfados.	e nada mais tem lugar pelo que você já não o irrita.	21.82173450212568
dos q lhe dei me peza mto mto	Dos que lhe dei, me pesa muito muito.	Eu lhe dei um pedaço de mim mesmo.	9.442944296079734
N S 4 de Agosto de 1745	Nossa Senhora, 4 de agosto de 1745.	NS 4 DE AGOSTO DE 1745	5.854497694024015
de huma alma q ja fica como Vmces podião esperar nas suas demoras e negasois	De uma alma que já fica como VMs podiam esperar, nas suas demoras e negações,	de uma alma que já fica como Vmces pode esperar em seus atrasos e negáveis	30.448675453278828
Franca jozepha	Francisca Josefa	Franca jozepha	0.0
Meu prozuradiçimo [...] amor	Meu prezadíssimo [...] amor,	Meu provisionadisimo [...] amor	62.401954419369176
reçebi u mimmo das [...] tam estimadas exproçoes as quaes oni o meu peito como [...] de hum obigeto guntamente Sintindo mto u não ter podido escreverlhe	Recebi o mimo das [...] tão estimadas expressões, as quais uni ao meu peito como [...] de um objeto, juntamente sentindo muito o não ter podido escrever-lhe.	Recebi o mimo das [...] tão estimadas exposições as quais o meu peito como [...] de um objeto com razão Sinto ou não ter podido escrevê-lo	57.57318583996251
mais não he por descudo meu	Mas não é por descuido meu.	mais não tenho por descuido meu	27.482545710800192
he para mor de a minha mana porque Sempre handa descomfiada commigo i ter me osconsdido os tinteiros	É para mor de a minha mana, porque sempre anda desconfiada comigo, e ter-me escondido os tinteiros.	Eu morro de minha mão porque eu sempre desconfiei de mim e escondi os tinteiros.	9.060000441661114
mais agora que tive lugar cero dar resposta as suas queridas letras pois tanto as estimo i venero [...] pois basta Ser do meu iternos amores para as estimar i venerar como coiza Sua	Mas agora, que tive lugar, quero dar resposta às suas queridas letras, pois tanto as estimo e venero, [...] pois basta ser do meu eternos amores para as estimar e venerar como coisa sua.	mais agora que eu tive lugar zero dar respostas às suas queridas letras pois tanto as amo e venero... pois basta ser do meu amor eterno para amá-las e venerar como coça Sua	23.48453483546348
meu querido amores não Sabe o que tem estado a minha tia de agastada do que handam dezendo la pelo comvento dehela pois ja tem as ginelas fichadas i p [...] ereçeme que nunca se habriam a un hum padre ja velho que lla hia	Meu querido amores, não sabe o que tem estado a minha tia de agastada do que andam dizendo lá pelo convento dela, pois já tem as janelas fechadas e parece-me que nunca se abriam a um padre já velho que lá ia.	Meus queridos amores não sabem o que minha tia tem sido de cansada do que têm vindo a dar o cabelo ao convento dela, pois já tem as suas virgens afiadas, e eu sei que nunca se haveria um padre já velho que a hiaria.	26.858033315809934
hoitro dia hia a fazer huma vizita achandone eu la tambem i foi a minha prima a porta i dice que não estava sua mai em caza	Outro dia, ia a fazer uma visita, achando-me eu lá também, e foi a minha prima à porta e disse que não estava sua mãe em casa.	Ontem foi dia de fazer uma visita achando eu também, e minha prima foi a porta e disse que não estava sua mãe em caça.	38.43917917299039
i tem tudo fichado para mor dle porque heile hera hum tollo	E tem tudo fechado para mor dele, porque ele era um tolo.	Ele está preso porque ele é um louco.	6.506124089578341
the u forei Antonio ja não vinha caza dela para mor dele	Até o Frei António já não vinha casa dela para mor dele.	O Antonio não vinha mais caçar por causa dele.	8.792330837055141
com isto não emfado mais	Com isto não enfado mais.	Não estou mais com raiva.	9.652434877402245
desta Sua umilde criada que mto lhe cer i dezeja a vida athe a morte	Desta sua humilde criada que muito lhe quer e deseja a vida até à morte,	desta Sua humilde criada que eu lhe peço e deleita a vida até a morte	17.032825081616245
Maria Françisca	Maria Francisca	Maria Françisca	49.99999999999999


Final score:	{'score': 27.084145250158386, 'counts': [1752, 948, 549, 315], 'totals': [2700, 2553, 2408, 2267], 'precisions': [64.88888888888889, 37.132784958871916, 22.799003322259136, 13.895015438906043], 'bp': 0.9163037106592573, 'sys_len': 2700, 'ref_len': 2936}