source	gold	translation	BLEU score
Avizo a V Pte q Noticie aos inquizidores q eu tenho dado a alma ao diabo, e q dezespero e aRenego de Ds Padre de Ds filho, e de Deos espyrito Santo, e de qtos Santos tem o Ceo; e q somte venero, amo, e adoro a Lucifer por Senhor de minha vida, e alma:	Aviso a Vossa Paternidade que noticie aos inquisidores que eu tenho dado a alma ao diabo e que desespero e arrenego de Deus, padre de Deus Filho e de Deus Espírito Santo e de quantos santos tem o céu, e que somente venero, amo e adoro a Lúcifer por senhor de minha vida e alma.	Eu crio ao v. P. Noticia aos inquiridores que eu deu a alma ao diabo, e q dezespero e aRenego de Ds Padre de Ds filho, e de Deus espyrito Santo, e de quetos Santos tem o Ceo; e q somte venero, amo, e adoro Lucifer por Senhor da minha vida, e alma:	10.662822031157635
e isto Repito, digo, e comfesso todos os instantes sem temor algũ desse Ds a qm athe gora Cegamte adorava pa meu mal;	E isto repito, digo e confesso todos os instantes, sem temor algum desse Deus, a quem até agora cegamente adorava para meu mal.	e isto Repito, digo, e resisti todos os momentos sem medo algũ da Ds a qm athe gora Cegamte adorava pa meu mal.	8.87823414549699
e porq desta mudança foy cauza o Pe Mel thomas, elle tenha o premio q dos infernaes spiritos espero	E porque desta mudança foi causa o padre Manuel Tomás, ele tenha o prémio que dos infernais espíritos espero.	E por esta mudança foy causa o Pe Mel thomas, ela tem o prémio q dos infernos, espero.	7.148072814198279
faso esta deliga por papel, porq a prizão me impozibilita pa a fazer eu proprio; e não Remeto as noticias a inquizidores algũ porq quero q seja V Pte obrigado a saber os Comfisados q tem, e a qm os emtrega; q infalivelmte me parese q está obrigado a dar pte deste cazo ao santo oficio,	Faço esta diligência por papel, porque a prisão me impossibilita para a fazer eu próprio, e não remeto as notícias a inquisidores algum porque quero que seja Vossa Paternidade obrigado a saber os confessados que tem e a quem os entrega; que infalivelmente me parece que está obrigado a dar parte deste caso ao Santo Ofício.	"" Doio esta liga por papel, "" por que o prision me impede "" a fazer eu mesmo; "" e não Receio as notícias "" algũ "" por que quero que seja V Pte "" obrigado a saber os Comisados "" q tem, e a qm entra; "" q infalivelmte "" parece-me que é obrigado a dar pte deste caço ao santo oficio,	9.577079136415175
e qdo o não faça prontisimamte creminarei a V Pte por consentidor das indozlencias com q o Pe Mel Thomas machado domina a Caza de Mariana da Silva, sem o atemorizar a Vista de Coatro Clerigos q por semelhantes Couzas Sahirão este a-cto de fé.	E, quando o não faça prontissimamente, criminarei a Vossa Paternidade por consentidor das indulgências com que o padre Manuel Tomás Machado domina a casa de Mariana da Silva, sem o atemorizar à vista de quatro clérigos que, por semelhantes coisas, saíram este ato de fé.	e se não fizer isso, antes creio no V.E. por consentir às inquisições, com que o Pe Mel Thomas achado dominava a caça da Maria da Silva, sem atemizar-o com a Vista de Coatro [Crião] por semelhantes Couzas Sahirão este acto de fé.	10.084570751211196
Não Repare na dezordem da escripta, q a pena com q fico não dá mais lugar q sertificarlhe q qqm dis isto he	Não repare na desordem da escrita, que a pena com que fico não dá mais lugar que certificar-lhe que quem diz isto é,	Não repara na dor da escripta, q pena com q fico não há lugar para q certifiquem q qqm dis isto he	5.3687145412727615
Antonio da Cruz e Silva	António da Cruz e Silva	Antonio da Cruz e Silva	66.87403049764218
Meu padrinho e mto meu Snor	Meu Padrinho e muito meu Senhor.	O meurinho e o meu Snor.	8.643019616048525
q Vm Logre saude	Que VM logre saúde.	"" Vm Saude "".	6.567274736060395
mto filis o estimarei Como quem a todos Vmces [...] he tão obrigada e devedora pella grandioza esmola q Vmces fizerão a Meu Irmão e pellos continos favores que de Vmces sempre resebemos	Muito feliz o estimarei, como quem a todos VMs é tão obrigada e devedora pela grandiosa esmola que VMs fizeram a meu irmão e pelos contínuos favores que de VMs sempre recebemos.	"" Eu estimava-o. "" Como todos os mamíferos — "" I've been so grato e grato "" — "" Mamíferos grande esmolo "" — "" I'm going to make a minha Irmão "" — "" Mamíferos grandes esmolo "" — "" I'm going to make favours que de mamíferos have always sido.	1.4657466945029212
tudo seja pello amor de Ds	Tudo seja pelo amor de Deus.	É tudo amor de Ds.	15.207218222740094
Meu padrinho e Snor hũa aflissão em q me vejo me obriga a fazer esta obrigada de meus confesores	Meu padrinho e Senhor, uma aflição em que me vejo me obriga a fazer esta, obrigada de meus confessores.	"" O meurinho e o meu Snor hood na q "" — vejo — obriga-me a fazer "" a favor dos meus fabricantes "".	3.3868193354396166
sabera Vm em Como eu estive no Convento da esperanssa de Abrantes	Saberá VM em como eu estive no Convento da Esperança, de Abrantes.	Conheciam em Como eu estive no Convento da Esperanza de Abrantes.	36.964463979752836
e estando na Conpanhia de duas freiras estas tais tendo notisia q lhe mudarão dali o Capellão e sendo suas particulares amigas so juntarao Com outras duas religiozas e fiandosse mim fizerão huma pineira pra saberem se o Capellão havia de ficar ou não	E, estando na companhia de duas freiras, estas tais, tendo notícia que lhe mudaram dali o capelão e sendo suas particulares amigas, se juntaram com outras duas religiosas e, fiando-se mim, fizeram uma peneira para saberem se o capelão havia de ficar ou não.	"" E, "" E, "" E, "" E, "" E, "" E, "" E, "" E, "" E, "" E, "" E, "" E, "" E, "" E, "" E, "" E, "" E, "" E, "" E, "" E, "" E, "" E, "" E, "" E, "" E, "" E, "" E, "" E, "" E, "" E, "" E, "" E, "" E, "" E, "" E, "" E, "" E, "" E, "" E, "" E, "" E, "" E, "" E, "" E, "" E, "" E, "" E, "" E, "" E, "	0.494723287156292
eu confesso q fui buscar a pineira e quis asistir pa ver Como se voltava a pineira e sem lhe bolirem q hera o sinal q dava pa dizer sim o não	Eu confesso que fui buscar a peneira e quis assistir, para ver como se voltava a peneira e sem lhe bulirem, que era o sinal que dava para dizer sim ou não.	Eu confess: "" Eu fui buscar a teia. "" Eu queria ver "" Eu me fui buscar a teia. "" Eu queria ver "" Eu me fui "" sem tocar no teia. "" Eu respondi. "" Eu respondi. "" Eu respondi. "" Eu respondi. "" Eu respondi. ""	2.4918868101620957
mas não vi com medo de q me não quizesem asolver	Mas não vi, com medo de que me não quisessem absolver.	"" Mas não vi com medo de que eu messes.	29.167552921712726
as q nesta ocasião a fizerão são as seguintes Me dona Ma madalena dona he a qual he agora abadessa e a Me Antonia Ma e a Me Catherina dos Saraphns e a Me violante Ma de jasus	As que nesta ocasião a fizeram são as seguintes: Madre Dona Maria Madalena, dona e a qual é agora abadessa, e a Madre Antónia Maria e a Madre Catarina dos Sarafins e a Madre Violante Maria de Jesus.	O que vocês vão fazer, neste momento, são as siguientes: "" Me Donha Maddalena He, "" a que eu sou agora abadessa "" e "" Me Antonia Ma, "" a que eu sou Catherina dos Saraphns, "" e a que eu sou violante.	2.826347420763287
estas são q eu sei q a fizerão mas suponho não continuam	Estas são que eu sei que a fizeram, mas suponho não continuam.	"" These are the ones I know you'll do, "" mas I suppose they don't continue.	2.5197593442434796
e isto havera dois annos pouco mais e menos	E isto haverá dois anos, pouco mais e menos.	Isto would have two doses, a little more and a little less.	3.377156414337854
tambem A Me Joanna Catherina do mesmo Convento se gabou q a fizera	Também a Madre Joana Catarina, do mesmo convento, se gabou que a fizera.	"" Joanna Catherina, "" from the same convent, if she fought...	2.8265205879007453
e eu Snor padrinho, tenho prezunssão de q mtas tem feito isto	E eu, Senhor Padrinho, tenho presunção de que muitas tem feito isto.	"" Eu sou um périnho, "" eu sou um périnho. "" Eu sou um périnho.	2.3901021968803136
asim pesso a Vm pello amor de Ds q se governe isto no milhor modo q puder ser e pa q eu fique descanssada de q Vm esta entregue desta	Assim, peço a VM, pelo amor de Deus, que se governe isto no melhor modo que puder ser e para que eu fique descansada de que VM está entregue desta.	"" E peço a vm amor de Ds. "" q se governar desta forma, "" q pode ser, "" e p. "" I'll have reposo de q. "" Vm esta entregue a esta.	3.0876289635639047
espero q Vm me Responda Remetendo a Resposta a Snra dona Lionor minha Snra	Espero que VM me responda, remetendo a resposta à Senhora Dona Leonor, minha Senhora.	Espero que me respond, Retorndo à Sra. dona Lionor, à minha Sra.	6.498093221863573
eu fico pedindo a Ds gde a Vm mtos anos	Eu fico pedindo a Deus guarde a VM muitos anos.	"" I'm asking a D. "" For 50 anos.	6.837203339116283
Sardoal dezasseis de marso mil e setesentos e vinte e dois	Sardoal, dezasseis de março, mil e setecentos e vinte e dois	São Paulo, São Paulo: São Paulo, São Paulo: São Paulo: São Paulo: São Paulo: São Paulo: São Paulo: São Paulo: São Paulo: São Paulo: São Paulo: São Paulo: São Paulo: São Paulo: São Paulo: São Paulo: São Paulo: São Paulo: São Paulo: São Paulo: São Paulo: São Paulo: São Paulo: São Paulo: São Paulo: São Paulo: São Paulo: São Paulo: São Paulo: São Paulo: São Paulo: São Paulo: São Paulo: São Paulo: São Paulo: São Paulo: São Paulo: São Paulo: São Paulo: São Paulo: São Paulo: São Paulo: São Paulo: São Paulo: São Paulo: São Paulo: São Paulo: São Paulo: São Paulo: São Paulo: São Paulo: São Paulo: São Paulo: São Paulo: São Paulo: São Paulo: São Paulo: São Paulo: São Paulo: São Paulo: São Paulo: São Paulo: São Paulo: São Paulo	0.2150665387640756
de Vm Afilhada e menor Criada	De VM afilhada e menor criada,	de Vm Afilhada e mais pequena Criada.	5.522397783539471
Joanna da Me de Ds	Joana da Madre de Deus	Joanna da Me de Ds	12.703318703865365
Meo amo e Sr	Meu Amigo e Senhor,	Eu amo. Sr.	0.0
Ainda q VM me não quer dar o alivio de suas novas a minha amizade não pide tal discuido e assi lembresse VM de mim [...] com novas suas q bem sabe q não tem qm lhas dezeje com mais veras	ainda que VM me não quer dar o alívio de suas novas, a minha amizade não pide tal descuido e, assim, lembre-se VM de mim com novas suas, que bem sabe que não tem quem lhas deseje com mais veras.	"" Ainda q VM não quer dar a alivio da sua nova à minha amiga "" não pede por tal discusso "" e então chama-me VM de mim [...] "" com novas "" q bem sabe q não tem qm ""lhas "" com mais verdades.	6.447847770682287
Sabado nove deste mes Domingos de Moraes Clerigo em minoribus nal de Vinhais veyo a esta casa e entre praticas q tivemos me dice, q hũ Rapaz chamado Sebam filho do Capam Franco Roiz da ditta va de Venhais perguntara a hũ Rapaz pequeno filho de Manoel Roiz Cané Christão Novo q fazião as noites em sua casa;	Sábado, nove deste mês, Domingos de Morais, clérigo em minoribus, natural de Vinhais, veio a esta casa e entre práticas que tivemos me disse que um rapaz chamado Sebastião, filho do capelão Francisco Rodrigues da dita vila de Vinhais, perguntara a um rapaz pequeno, filho de Manuel Rodrigues Cané, cristão-novo, que faziam às noites em sua casa.	No dia nove de este mes, Domingos de Moraes clírico em minus nal de Vinhais, vejo esta casa e entre prácticas que tivemos de dizer, que o meu Rapaz chamado Sebam filho do Capam Franco Roiz da ditta va de Venhais perguntava ao meu Rapaz pequeno filho de Manoel Roiz Cané Cristo Nova que passava as noites na sua casa.	9.98975266539384
[...] o tal Rapaz Respondera, q seu pay dizia Missa, [...] Manoel Roiz Pechuga de alcunha christão novo lhe ajudava, e q Pascoal Ramos tãobem christão novo q tomava sobrepeliz, e q ao dito Rapaz o punhão sobre o altar, e q sua May asoutava hũ santo christo com hua corda	[...] O tal rapaz respondera que seu pai dizia missa, [...] Manuel Rodrigues, Pechuga de alcunha, cristão-novo, lhe ajudava e que Pascoal Ramos, também cristão-novo, que tomava sobrepeliz, e que ao dito rapaz o punham sobre o altar e que sua mãe açoutava um santo Cristo com uma corda.	["" O Rapaz respondeu, "" Q "" O seu pay era Missa, [...] ["" Manoel Roiz ""] ["" A Pechuga de nome novo ""] [""" A Helpa ""] [""] E q Pascoal Ramos [""] ["" A Helpa ""] ["] E q toma sobrepeliz, "" ["" O Rapaz ""] ["] Colocou o altar, "" e q a sua Mayou ["" O Santo Cristo ""] ["] ["" Oũ comhua corda]	5.921618126936456
E no mesmo dia de tarde veyo tãobem a minha casa o pe gco Frco de Amal nal de Vinhais e perguntandolhe eu pello sobredito me Respondeo, q era tanto verde, q dizendolhe tres Mulheres o Referido prendera o Rapaz em sua casa, e lhe confessara tudo o narrado,	E no mesmo dia de tarde veio também a minha casa o padre Gonçalo Francisco de Amaral, natural de Vinhais, e, perguntando-lhe eu pelo sobredito, me respondeu que era tanto verdade, que, dizendo-lhe três mulheres o referido, prendera o rapaz em sua casa e lhe confessara tudo o narrado.	E na mesma tarde, vejo na minha casa o Pegco de Amal nal de Vinhais e perguntei-lhe "" Porquê? "" Eu respondi, "" Que era tão verde, "" Que disse a três Mulheres. "" O juiz agarrou ao Rapaz na sua casa, e confessou-lhe tudo.	4.8510415321733795
e supposto q disto se terá dado pte eu o faço a VM por não ficar com escrupello	E, suposto que disto se terá dado parte, eu o faço a VM por não ficar com escrúpulo.	E assume que isso foi dado, eu faço-o ao VM para não ficar enganado.	6.198090975357433
aqui fico ás ordens de VM pa o q me quizer mandar com gde vontade	Aqui fico às ordens de VM para o que me quiser mandar com grande vontade.	"" Here's a VM pa o q me quizer, "" Send-me-a-da-da! ""	3.009804384352828
Ds gde a VM	Deus guarde a VM.	Por favor, use a VM.	24.446151121745054
Prada 10 de Julho de 1712	Prada, 10 de julho de 1712	No dia 10 de 1712,	19.43309443637608
Mayor Amo e Servidor de VM	Maior amigo e servidor de VM,	São Tomé e Príncipe.	7.16047614494885
Franco de SáMzes	Francisco de Menezes	Franco de Sámzes	27.516060407455225
Meu filho todo do meu Coracão	Meu filho todo do meu coração.	O meu filho, o meu Coracán,	6.567274736060395
não te poso expeLicar o sentimento Com que estou por tu te hires emvora mas Como tenho a Serteza que tu veis Logo por iso me fica aLguma ConsoLacão	Não te posso explicar o sentimento com que estou por tu te ires embora, mas, como tenho a certeza que tu vens logo, por isso me fica alguma consolação.	"" Não posso expe liar o sentimento "" Como eu estou por tu te hires "" mas "" Como eu tenho a Serteza que tu vês "" Logo, é que eu fica "" Someone ConsoLacan "".	8.690841065463829
tu bem saves que eu não tenho a nimgem senão a ti e so a ti he que amo e so a ti he que quero pois so tu hes o meu amor	Tu bem sabes que eu não tenho a ninguém senão a ti e só a ti é que amo e só a ti é que quero, pois só tu és o meu amor.	"" Bem sabe que eu não tenho a nemgem "" except para ti "" e eu só amo "" e eu só quero "" porque eu só, eu só, o meu amor.	17.13317975176325
agora baste emvora eu fico So e Com mtas saudades do meu menino	Agora vais-te embora, eu fico só e com muitas saudades do meu menino.	Agora, baste emvora, eu sou. Com saudades de meu menino.	13.46216659120865
olha se por La me podes perder o amor pois eu te sou firme e hei de Ser e se Cuidas houtra couza inganaste pois tu ainda não saves bem o Coanto eu te quero	Olha se por lá me podes perder o amor, pois eu te sou firme e hei de ser e, se cuidas outra coisa, enganas-te, pois tu ainda não sabes bem o quanto eu te quero.	"" Se por Lei podes perder o amor "" porque eu sou forte "" e vou ser. "" E se Cuidas woodra couza "" enganas "" porque tu ainda não sei bem "" O quanto eu quero "".	9.12659738662783
adeos meu rico marido	Adeus, meu rico marido.	Olá ao meu marido rico.	11.478744233307168
pasa bem por La que eu aqui fico sentindo esta auzensia pa mim tam Custoza	Passa bem por lá, que eu aqui fico sentindo esta ausência para mim tão custosa.	passa bem por que eu estou aqui, sentindo a essência pa mim tam Custoza	7.735984567871263
aseita agora mtas saudades do teu Coninho que fica Com mtas saudades do seu menino	Aceita agora muitas saudades do teu coninho, que fica com muitas saudades do seu menino.	Agora ama o teu menino que fica com os seus bebés.	9.88274679095246
as tuas maminhas tambem te mandam mtos abrasos e adeos meu menino emthe a bista pois dezejarei Seja Logo pa meu aLivio	As tuas maminhas também te mandam muitos abraços e adeus, meu menino, até à vista, pois desejarei seja logo para meu alívio.	"" As tuas mães também mandam becas. "" "" Oh, "" Oh, "" Oh, "" Oh, "" Oh, "" Oh, "" Oh, "" Oh, "" Oh, "" Oh, "" Oh, "" Oh, "" Oh, "" Oh, "" Oh, "" Oh, "" Oh, "" Oh, "" Oh, "" Oh, "" Oh, "" Oh, "" Oh, "" Oh, "" Oh, "" Oh, "" Oh, "" Oh, "" Oh, "" Oh, "" Oh, "" Oh, "" Oh, "" Oh, "" Oh, "" Oh, "" Oh, "" Oh, "" Oh, "" Oh, "" Oh, "" Oh, "" Oh, "" Oh, "" Oh, ""	0.5222021114783255
adeos	Adeus.	Olá.	49.99999999999999
aseita desta tua molher mtos abrasos e mtos beiginhos	Aceita desta tua mulher muitos abraços e muitos beijinhos.	Gostava de ter morcegos e morcegos.	5.08764122072739
Desta que deveras te quer e ama emthe a morte	Desta que deveras te quer e ama até à morte,	O que deveras querer e amar emite a morte.	9.030367376343264
Meu Marido todo o meu bem	Meu Marido, todo o meu bem.	"" Meu Deus, todo o meu bem.	53.7284965911771
não te poso expeliCar as lagrimas que Choro Com saudades tuas pois me parese que ha hum anno que te não bi	Não te posso explicar as lágrimas que choro com saudades tuas, pois me parece que há um ano que te não vi.	"" Não posso expelirar as lagras que choro "" Com as suas saudades "" porque parece que há hum ano que não te bia.	8.688218206838483
em Cegundo lugar desejarei esta te aChe Com saude pois he o que mais te desejo	Em segundo lugar, desejarei esta te ache com saúde pois é o que mais te desejo.	"" Em lugar deste, eu adore-te. "" Sinceramente, "" é o que mais eu quero.	12.858902882463452
eu fiCo boa pa te dar gosto	Eu fico boa, para te dar gosto.	"" Bon appetite. "" (Risos)	4.196114906296549
meu filho Ca resevi a fita	Meu filho, cá recebi a fita.	O meu filho Ca, rescreveu a fita.	20.164945583740657
pois te Comfeso que o estimei mto mas mto mais a havia de estimar se fose mto mais pois intam Conhesia que tu tinhas siumes de mim	Pois te confesso que o estimei muito, mas muito mais a havia de estimar, se fosse muito mais, pois então conhecia que tu tinhas ciúmes de mim.	"" Porque eu te persuadei que era mais, "" mas mais, "" eu tinha que persuadir "" se era mais, "" porque naceu a Conhesia "" que tu tinha sim de mim.	5.78083904183164
mas Como ma mandastes bermelha he serto que estas em guera Comigo	Mas, como ma mandastes vermelha, é certo que estás em guerra comigo.	"" Como me mandais bermelha "" — "" Forgive-me que estea em guera "" — "" Eu sei.	2.0705706652424007
tu bem saves que eu sou mto tua e que não amo a mais nimgem senão a ti pois so tu hes o meu bem e todo o meu amor	Tu bem sabes que eu sou muito tua e que não amo a mais ninguém senão a ti, pois só tu és o meu bem e todo o meu amor.	"" Se bem sei que eu sou teu e que não amo mais a mulher "" se não ti "" porque sou "" Tu és o meu bem "" e todo o meu amor.	27.676881670261977
meu menino quem me dera ja berte pa te dar mtos abrasos e mtos beiginhos e meterte a linguinha toda nesa boquinha	Meu menino, quem me dera já ver-te para te dar muitos abraços e muitos beijinhos e meter-te a linguinha toda nessa boquinha.	"" Oh, oh, oh, oh, oh, oh, oh, oh, oh, oh, oh, oh, oh, oh, oh, oh, oh, oh, oh, oh, oh, oh, oh, oh, oh, oh, oh, oh, oh, oh, oh, oh, oh, oh, oh, oh, oh, oh, oh, oh, oh, oh, oh, oh, oh, oh, oh, oh, oh, oh, oh, oh, oh, oh, oh, oh, oh, oh, oh, oh, oh, oh, oh, oh, oh, oh, oh, oh, oh, oh, oh, oh, oh, oh, oh, oh, oh, oh, oh, oh, oh, oh, oh, oh, oh, oh, oh, oh, oh, oh, oh, oh, oh, oh, oh, oh, oh, oh	0.18084868148773522
as tuas maminhas todas tuas e de mais nimgem não so sam tuas e tudo Coanto he meu he so pa o meu marido pois so a ele quero e so a ele amo	As tuas maminhas, todas tuas e de mais ninguém não, só são tuas e tudo quanto é meu é só para o meu marido, pois só a ele quero e só a ele amo.	"" As tuas mães, "" E mais uma mãe, "" E mais uma mãe, "" E mais uma mãe. "" E mais uma mãe. "" E mais uma mãe. "" E mais uma mãe. "" E mais uma mãe. "" E mais uma mãe. "" E mais uma mãe. "" E mais uma mãe. "" E mais uma mãe. "" E mais uma mãe. "" E mais uma mãe. "" E mais uma mãe. "" E mais uma mãe. "" E mais uma mãe. "" E mais uma mãe. "" E mais uma mãe. "" E mais uma mãe. "" E mais uma mãe. "" E mais uma mãe. "" E mais uma mãe. "" E mais uma mãe. "" E mais uma mãe. "" E mais uma mãe. "" E mais uma mãe. "" E mais uma mãe.	0.4998368759912164
vejo o que me dizes que te diseram que eu tinha alugado humas Cazas e tambem do torto de ponte	Vejo o que me dizes que te disseram: que eu tinha alugado umas casas e também do Torto de Ponte.	"" I see what you're saying. "" I've been told I've rented cabins. "" I've rented doucos.	1.6466642419110007
saveras que tudo he huma pouCa de mentira pois eu não sou Capas de te inganar	Saberás que tudo é uma pouca de mentira, pois eu não sou capaz de te enganar.	"" Separam-se de todas as mentiras "" — "" Porque eu não sou Capa de Toner "".	7.645949399477267
e te digo que tudo he mentira isto o podes querer Como tua molher que sou	E te digo que tudo é mentira – isto o podes crer – como tua mulher que sou!	"" E digo-vos: "" Eu menti. "" E digo-vos: "" Eu merei. "" E digo-vos: "" Eu merei. "" Como tu molher que sou.	2.144958285037965
não te fies [...] em quem me quer mal pois te dezega dizer Couzas pa que tu não tornes a falar Comigo nem querem que tu mandes nada	Não te fies em quem me quer mal, pois te deseja dizer coisas para que tu não tornes a falar comigo, nem querem que tu mandes nada.	"" Não te preocupes com quem me quere, "" porque me disse "" Couzas pa que tu não tornes a falar. "" (Risos) "" Eles não querem que tu mante nada.	17.726777658225775
vejo o que me dizes que neste Coreio me mandas huns sapatos bonitos	Vejo o que me dizes, que neste correio me mandas uns sapatos bonitos.	"" I see what you're telling me. "" In Korea, I keep these beautiful shoes.	2.5197593442434796
eu hei de estimar mto por serem da tua mam	Eu hei de estimar muito, por serem da tua mão.	"" Eu sei por serem da tua mãe.	23.801761257033814
tambem vejo o que me dizes que me queres mandar os pratos e as mais Cozas	Também vejo o que me dizes, que me queres mandar os pratos e as mais cousas.	"" E também vejo o que me diz: "" Querem mandar-me as pratos e as más Cozas "".	15.415064977510756
Rec reComendo oo home da lanCha que não de iso senão a preta ou [...] a mim	Recomenda ao homem da lancha que não dê isso senão à preta ou [...] a mim.	Recomendo eu home da lancha que não seja a truia ou [...] para mim.	37.51762297326676
que não soseda Como da outra bes	Que não suceda como da outra vez.	que não sede como o outro bes.	7.267884212102741
tu reComenda tambem ao Coreio que não de a Carta senão a preta	Tu recomenda também ao correio que não dê a carta senão à preta.	"" Recomenda a Coreia "" que não use a Carta "" "não use a pena"	4.237713199752784
adeos meu filho	Adeus, meu filho.	Olá a meu filho.	39.76353643835252
adeos meus amores	Adeus, meus amores.	Olá aos meus queridos.	12.703318703865365
aseita mtos abrasinhos as tuas maminhas e da tua boquinha perninhas pentilhinho e do teu Coninho que esta tam goardadinho so pa o meu Rico marido todo do meu CoraCão	Aceita muitos abracinhos das tuas maminhas e da tua boquinha, perninhas, pentelhinho e do teu coninho, que está tão guardadinho só para o meu rico marido, todo do meu coração.	"" Cuidado, cuidado! Cuidado! Cuidado! Cuidado! Cuidado! Cuidado! Cuidado! Cuidado! Cuidado! Cuidado!	0.9948511484873499
adeos meu filho	Adeus, meu filho.	Olá a meu filho.	39.76353643835252
toma hum beiginho e hum abrasinho que to manda a tua molher	Toma um beijinho e um abracinho que to manda a tua mulher.	"" Tome um beijo "" e umbrass "" que me manda para o teu molher.	3.0272532566104675
Desta que tam deveras te ama e ha de amar a tua	Desta que tão deveras te ama e há de amar, a tua	"" O que é que deve amar "" e deve amar a tua	6.608973813188645
Maria gabriela	Maria Gabriela	Maria Gabriela.	55.03212081491043
J M J	Jesus Maria José	"" J. M. ""	0.0
M amado Sr	Muito amado senhor	"" Dear Sr.	0.0
Custo, saude e paz em o sor	Custódio, saúde e paz em o Senhor.	Custo, saude and peace in the sun.	5.669791110976001
sendome precizo chegar a esta caza aonde me dizem q VM estivera, senti m não o achar nella, porq tinha q lhe com-unicar materias de importancia;	Sendo-me preciso chegar a esta casa onde me dizem que VM estivera, senti muito não o achar nela, porque tinha que lhe comunicar matérias de importância.	Eu seitamente, ao chegar a esta caça onde me disseram que o VM estava, eu sentia que não o considerava, porque eu tinha que unir coisas de importância.	11.20410050358964
mas suposta a sua retirada terei por hora pa-ciencia;	Mas, suposta a sua retirada, terei por ora paciência.	Mas supostamente, I'll have an hour de paciência.	8.171014300726602
e só se me offerece dizerlhe por letra, q em Beja se espera q VM vá pregar hũa quaresma q lá lhe está aceita na boa fé de q não tinha nisso duvida;	E só se me oferece dizer-lhe por letra que em Beja se espera que VM vá pregar uma quaresma que lá lhe está aceite, na boa fé de que não tinha nisso dúvida.	e só se me offer a letra, q em Beja se espera que q VM vá pregar um chapéu, q lá está aceite na boa de q não duvido.	20.22236686101141
e assim espero q não falte a isto, e despois, da-lo q por Mis-sionar ali o Pe Fr Afonso, não tenha VM lu-gar de fazer logo o mesmo como estava deter-minado;	E, assim, espero que não falte a isto e, depois, dá-lo que, por missionar ali o padre frei Afonso, não tenha VM lugar de fazer logo o mesmo como estava determinado.	E então espero que não falha sobre isto, e depois, por Mis-sionar ali o Pe Fr Afonso, não teve de lugar para fazer logo o mesmo que estava a ter-minado.	15.391480600257504
bem sabe q em Moura me empenhou o Vigo da vara com toda a instancia pa q lhe desse missão áquella terra;	Bem sabe que em Moura me empenhou o vigário da vara com toda a instância, para que lhe desse missão àquela terra.	Bem, em Moura, o Vigo da Vara empenhou-me com toda a oportunidade de dar a mission to that terra.	9.66090831689451
e assim fio do seu zelo, q não faltará a isto, satisfazendo primo á quaresma q roca á Beja;	E, assim, fio do seu zelo, que não faltará a isto, satisfazendo primeiro a quaresma que roca a Beja.	E assim, o seu zelo, q não faltará para isto, satisfindo o quadrante q roca a Beja.	19.064433353290465
porq aliás, sera m sensivel ali a sua falta, e eu mais q ninguẽ o sentirei;	Porque, aliás, será muito sensível ali a sua falta, e eu mais que ninguém o sentirei.	"" De facto, "" I'll be sensible à sua falta, "" e eu nunca mais o sentiria.	8.9275746495808
o q não prezumo, não só pela pontu-alide, com q VM obra no q o Prelado lhe ordena, mas tambem porq estou certo de q não se esqueçe do qto o meu affecto lhe merece;	O que não presumo, não só pela pontualidade com que VM obra no que o prelado lhe ordena, mas também porque estou certo de que não se esquece do quanto o meu afeto lhe merece.	"" O q não presume, "" não presume, "" não presume, "" o q VM trabalha no q o Prelado ordena, "" mas também porque estou certo de que o q não se esqueça do q que o meu trabalho merece.	17.22519337704325
á cuja pessoa Ds gde	A cuja pessoa Deus guarde.	"" Whom é que eu? ""	0.0
Evora em 12 de Fevero de 1749	Évora, em 12 de fevereiro de 1749.	Era o 12 de Fever de 1749.	22.811360354329615
Teu ir e servo affectuozisso	Teu irmão e servo afetuosíssimo,	"" O teu ir e o meu servo aficionado ""	4.02724819242185
Fr Jozé do Redo Vigo Proval	frei José do Redo, vigário provincial	Fr Jozé do Redo Vigo Proval	13.741272855400096
Ma Sra D Tomazia Izabel Gonzaga	Minha Senhora Dona Tomásia Isabel Gonzaga.	A Sra. D. Tomazia Isabel Gonzaga	12.22307556087252
Aos pes de Vmce me chego, ainda q com pouco conhecimto, sempre animado por ser sra, cujas prendas tendo ouvido louvar mto, e por ser filha de outra sra a qm em N Sr amo, qto não sei explicar.	Aos pés de VM me chego, ainda que com pouco conhecimento, sempre animado por ser Senhora cujas prendas tenho ouvido louvar muito e por ser filha de outra senhora a quem em Nosso Senhor amo, quanto, não sei explicar.	Aos pes de Vmce cheio, ainda q com pouco familiar, sempre animado por ser a rapariga, cujas roupas ouvimos falar de rapariga, e por ser a filha de outra rapariga a qm em N. Eu amo, que não sei explicar.	20.94093749331524
Não ha couza neste mũdo, q não tenha remedio:	Não há coisa neste mundo que não tenha remédio.	"" No, não, não, não, não, não.	3.377156414337854
não ha mal q sempre dure:	Não há mal que sempre dure.	Não mal q é sempre dura.	9.287528999566801
confeço, e estou mto bem informa-do [...] do mto q nesa caza padece.	Confesso, e estou muito bem informado, [...] do muito que nessa casa padece.	creio, e estou muito bem informado do quão que sofre na caça.	25.22382261656908
eu o sei mto bem de verde,	Eu o sei muito bem de verdade.	Eu sei bem pelo verde.	8.22487964923291
e sinceramte lhe confeço, q a ser ja conveniente, eu mesmo fora, qm com a sra sua Mai, fizera tod as deligas pa dahi a tirar.	E sinceramente lhe confesso que, a ser já conveniente, eu mesmo fora quem, com a Senhora sua mãe, fizera todas as diligências para daí a tirar.	E, sinceramente, eu, eu, eu, eu, eu, eu, eu, eu, eu, eu, eu, eu, eu, eu, eu, eu, eu.	2.7410126102418366
porem tudo tem seu tempo,	Porém, tudo tem seu tempo.	Porem, everything has a tempo.	14.535768424205482
e rezoluçoens apre-sadas são precipicio certo.	E resoluções apressadas são precipício certo.	E resoluções apretadas are a truque.	14.535768424205482
Veja q em hũ peito nobre, como o seu, não dizem bem vilanias, e menos lhe estão bem inconsiderações.	Veja que em um peito nobre como o seu não dizem bem vilanias, e menos lhe estão bem inconsiderações.	Vejam que nobre peito, como o seu, não fala bem, e menos está desconsiderado.	13.534578291953025
Disfarçar he bizar-ria, e generozide de animo.	Disfarçar é bizarria e generosidade de ânimo.	Disfarcer de bizarra, e generosidade de animosidade.	19.070828081828378
Desfarce por hũ pouco, coma, disimule, q Ds he grde,	Disfarce por um pouco, coma, dissimule, que Deus é grande.	Desenha por pouco, como, digamos, q Ds he grde.	7.52885143038073
entretãto se podem dar ordem aos meyos pa o seu alivio.	Entretanto, se podem dar ordem aos meios para o seu alívio.	se podem dar orden aos mosquitos para os aliviar.	13.76074141597786
A mim me tem, pa qto lhe poder servir com aquela vonte, q em seu mesmo Pai experimentaria.	A mim, me tem para quanto lhe puder servir, com aquela vontade que em seu mesmo pai experimentaria.	Eu tenho, eu posso servir-lhe aquela fralda, que o seu próprio Pai experimentaria.	4.894567591103194
Não desdoure com açoens de hũ dia o credito, e louvores, q com a sua nobreza, e bela indole toda vida tem grangeado.	Não desdoure com ações de um dia o crédito e louvores, que com a sua nobreza e bela índole toda vida tem granjeado.	Não assombram-se com assuntos de dia o crédito, e louvores, q com a sua pobreza, e bela indole toda a vida.	15.57163134378706
Pondere a suprema, e infinita Mage de Ds S N, q creou a vmce aos Anjos, a todo mũdo irado contra vmce, q pode tomar vingança das injurias, q vmce a sua mesma Mai está fazendo, q Ds toma por seus os agravos feitos a Mays.	Pondere a suprema e infinita majestade de Deus Senhor Nosso que criou a VM, aos Anjos, a todo mundo irado contra VM, que pode tomar vingança das injúrias que VM a sua mesma mãe está fazendo, que Deus toma por seus os agravos feitos a mães.	Ponder a suprema, infinita Magia de Ds. N., que criou a vossa das Anjos, que todo o corpo está aborrecido contra a vossa, que pode tomar venção das injurias, que vossa a mesma Mai está a fazer, que Ds. toma por si os agravos feitos às Mayas.	10.95213427246558
Espero de vmce, e do seu generozo animo me não falte, ao q lhe peço prostrado a seus pes,	Espero de VM e do seu generoso ânimo me não falte ao que lhe peço prostrado a seus pés.	Espero que chegue, e do seu generoso amor não falte, ao que eu peço para os seus peixes.	17.001078098404236
e vem a ser, q coma, q de gloria a Ds; confuzão a satanas, e espere hũ pouco, q Ds descubra meyos eta de se ver livre desa caza.	E vem a ser que coma, que dê glória a Deus, confusão a Satanás, e espere um pouco que Deus descubra meios, etc, de se ver livre dessa casa.	E vem, q como, q de gloria a Ds; confusa as satanas, e espera um pouco, q Ds descobre-me pronto para ser livre da caça.	4.513277985227166
Meu Pai.	Meu Pai.	Meu Pai.	100.00000000000004
Da boca do Rio escrevo esta a Vmce pa lhe dizer q chegando nós a ella, topamos essas Cartas do Pe Penha, e logo da outra banda ao Sergio com tudo o q havia na Fazenda.	Da boca do rio escrevo esta a VM para lhe dizer que, chegando nós a ela, topámos essas cartas do padre Penha e, logo da outra banda, ao Sérgio, com tudo o que havia na fazenda.	Da boca do Rio escrevo esta para Vmce pa dizer q chegando nós a ela, topando estas cartas do Pe Penha, e logo da outra banda ao Sergio com todo o q que havia na fábrica.	23.09855406929827
O Juiz lhe mandou em hũa Canoinha intimar a Portaria de S Excia e se Cazo elle não quizesse obedecer lhe dessem a vox de prezo.	O juiz lhe mandou em uma canoinha intimar à portaria de Sua Excelência e, se caso ele não quisesse obedecer, lhe dessem a voz de preso.	O juiz mandou-a a "" canoinha "" para inovar a porta da S. Excia, e se ela não pudesse obedecer, deram-lhe o prezo.	4.686621581836457
Elle foi tão insolente q não quis obedecer a nada, e tão pouco Christão q vendo se allagava a Canoinha nem ao menos quis acudir a gente, de forma q morreu afogado hũ pobre mosso chamado Gabriel, q tinha hido fazer a deligencia	Ele foi tão insolente que não quis obedecer a nada e tão pouco cristão que, vendo se alagava a canoinha, nem ao menos quis acudir a gente, de forma que morreu afogado um pobre moço chamado Gabriel que tinha ido fazer a diligência.	Ela era tão insolente que não queria obedecer a nada, e tão pouco a Cristo que, ao ver a Virgen, nem queria vir as pessoas, que morreu um pobre farcego chamado Gabriel, que tinha improvizado para fazer a diligência.	19.162753355829118
Elle leva tudo sem dar fiança, aRancou taxas, e destruhio tudo.	Ele leva tudo sem dar fiança, arrancou taxas e destruiu tudo.	Ela leva tudo sem fianza, aos impostos, e destruiu tudo.	28.917849332325716
Em-fim fica tudo acabado.	Enfim, fica tudo acabado.	E tudo fica acabado.	20.80119537801062
Por essa attestação de Retratação verá vmce o que fes Franc Aranha por induçoens de Jozé da Sa Contra D Quiteria	Por essa atestação de retratação, verá VM o que fez Francisco Aranha por induções de José da Silva contra Dona Quitéria.	Por essa attestação de Retratação, vmce o que vocês chamam Franc Aranha por induções de Jozé da Sa Contra D Quiteria.	15.41506497751075
Sergio aRancou da mão do homem a petição qdo lha foi intimar,	Sérgio arrancou da mão do homem a petição quando lha foi intimar.	Sergio aramhou a man with a request for intimação.	3.696719741302181
emfim Se S Excia não acudir a isto com pronto Remedio bem se pode consider tudo acabado.	Enfim, se Sua Excelência não acudir a isto com pronto remédio, bem se pode considerar tudo acabado.	Se o Excia não foresegue a pronto tratamento, bem se pode considerar que tudo está terminado.	21.395118732312095
Elle dis q se lhe não dá de ordens de S Excia	Ele diz que se lhe não dá de ordens de Sua Excelência.	"" She says, "" If you don't get orders from Excia,	0.0
Nós temos tido boa viajem, e já estamos livres de todo o perigo e até amenhã estamos em Caza.	Nós temos tido boa viagem e já estamos livres de todo o perigo e até amanhã estamos em casa.	Temos tido, e estamos livres de todo o perigo, e até hoje estamos em Caza.	31.247663570071495
Mandeme por este Portador as me-ias pretas.	Mande-me por este portador as meias pretas.	Mandem-me por este Portador.	12.975849993980741
Lembrcas a todos eta	Lembranças a todos, etc.	Lembrem de cada vez.	8.745825313180626
Ds Ge a Vmce eta	Deus guarde a VM, etc.	"" Ds Ge to Vmce "" é agora.	3.7477767366779213
Fo obde	Filho obediente,	Foi óbvio.	0.0
Miguel	Miguel	Miguel.	49.99999999999999
Mto Rdo Pe e Snr	Muito reverendo padre e senhor.	São Paulo, São Paulo, São Paulo.	4.767707020457095
Resebo a sua carta a qual me perdoe mas visto não serem os seus remedios ificazes pa a minha salvação pois so como sabe me salvaria não tem mais resposta q dizerlhe como me acho q suponho ficara satisfeito pois he o q podião esperar de semilhante negação demora e emganos com q tem Vmces tratado a minha alma	Recebo a sua carta, a qual, me perdoe mas, visto não serem os seus remédios eficazes para a minha salvação, pois só como sabe me salvaria, não tem mais resposta que dizer-lhe como me acho, que suponho ficará satisfeito, pois é o que podiam esperar de semelhante negação, demora e enganos com que têm VMs tratado a minha alma.	Resume a carta a que perdoa mas visto que não são os seus medicamentos ineficazes pa a minha salvação porque sou como sabe que me salvaria não tem mais resposta q dizer-lhe como me parece q Supo que ficaria satisfeito porque eu o q podem esperar de semícula negação demora e decepção com q Vmces tem tratado a minha alma	13.607601006880984
e como nem Ds nem a sua igreja e menistros podem valerme eu por ultima rezelucão digo a Vmce q renego de Ds; da sua may da trindade seus misterios sacramtos de tudo o q eles comtem como nulo e totalmte errado, por experiençia minha pois não tem poder	E, como nem Deus nem a sua igreja e ministros podem valer-me, eu por última resolução digo a VM que renego de Deus, da sua Mãe, da Trindade seus mistérios, sacramentos, de tudo o que eles contêm como nulo e totalmente errado, por experiência minha, pois não têm poder.	E como nem os seus igrejas e ministerios podem valer-me, eu, por último rezelucão, digo "" Vmce q renego de Ds; da sua may da trindade "" os seus sacramentos de todo o que eles cometam como nulo e completamente errado, por minha experiência, "" porque não tem poder ""	11.490290639891352
e de todo me emtrego ao demonio a quem so conheso por poderozo cuja he e a de ser sempre a minha comfição; e comunhão o q digo, e comfirmo mto em meu juizo perfeito,	E de todo me entrego ao demónio, a quem só conheço por poderoso, cuja é e há de ser sempre a minha confissão e comunhão, o que digo, e confirmo muito em meu juízo perfeito.	"" E de todo, eu entre no demon que eu conheço por poderozo "" — que eu conheço por sempre "" — "" e que eu confeço "" — no, "" eu "" — no, "" eu "" — no, "" eu "" — no, "" eu "" — no, "" eu "" — no, "" eu "" — no, "" eu "" — no, "" eu "" — no, "" eu "" — no, "" eu "" — no, "" eu "" — no, "" eu "" — no, "" eu "" — no, "" eu "" — no, "" eu "" — no, "" eu "" — no, "" eu "" — no, "" eu "" — no, "" eu "" — no, "	1.0927338863996372
e nada mais tem lugar pelo q portesto ja lhe não dar emfados	E nada mais tem lugar, pelo que protesto já lhe não dar enfados.	"" Nada de mais acontece por q portesto "".	3.1364240458810366
dos q lhe dei me peza mto mto	Dos que lhe dei, me pesa muito muito.	"" Dou-me um bocado. ""	4.300847718252331
N S 4 de Agosto de 1745	Nossa Senhora, 4 de agosto de 1745.	No 4 de Agosto de 1745.	23.099966849728546
de huma alma q ja fica como Vmces podião esperar nas suas demoras e negasois	De uma alma que já fica como VMs podiam esperar, nas suas demoras e negações,	de uma alma q ja fica como As moscas podem esperar nas suas demoras e negações.	28.175950490399515
Franca jozepha	Francisca Josefa	"" Franca Jozefa "".	0.0
Meu prozuradiçimo [...] amor	Meu prezadíssimo [...] amor,	"" My preservation... "" amor.	14.991106946711685
reçebi u mimmo das [...] tam estimadas exproçoes as quaes oni o meu peito como [...] de hum obigeto guntamente Sintindo mto u não ter podido escreverlhe	Recebi o mimo das [...] tão estimadas expressões, as quais uni ao meu peito como [...] de um objeto, juntamente sentindo muito o não ter podido escrever-lhe.	"" Recei-me de [...] Tam estimadas exproças as que eles [""] ["" O meu peito como... "" [""] ["" Obigeto guntamente ""] ["" Sinto mto ""] ["" Eu não pude escrever para ele ""]	9.876007157432852
mais não he por descudo meu	Mas não é por descuido meu.	"" No mais do que nunca.	5.522397783539471
he para mor de a minha mana porque Sempre handa descomfiada commigo i ter me osconsdido os tinteiros	É para mor de a minha mana, porque sempre anda desconfiada comigo, e ter-me escondido os tinteiros.	"" Estou chocado, "" porque "" sempre livrado, "" com gosto de ter os meus tinteiros "".	2.5330984049661036
mais agora que tive lugar cero dar resposta as suas queridas letras pois tanto as estimo i venero [...] pois basta Ser do meu iternos amores para as estimar i venerar como coiza Sua	Mas agora, que tive lugar, quero dar resposta às suas queridas letras, pois tanto as estimo e venero, [...] pois basta ser do meu eternos amores para as estimar e venerar como coisa sua.	"" Mas since I have no lugar para responder "" as suasridas letras "" porque tanto as estimo "" e veino [...] "" Porque basta ser do meu íterno amor "" para os reverem "" como a sua corça "".	14.83299085270031
meu querido amores não Sabe o que tem estado a minha tia de agastada do que handam dezendo la pelo comvento dehela pois ja tem as ginelas fichadas i p [...] ereçeme que nunca se habriam a un hum padre ja velho que lla hia	Meu querido amores, não sabe o que tem estado a minha tia de agastada do que andam dizendo lá pelo convento dela, pois já tem as janelas fechadas e parece-me que nunca se abriam a um padre já velho que lá ia.	"" Meu amor "" ["" Meu amor ""] [" Meu amor ""] [" Meu amor ""] [" Meu amor ""] [" Meu amor ""] [" Meu amor ""] [" Meu amor ""] [" Meu amor ""] [" Meu amor ""] [" Meu amor ""] [" Meu amor ""] [" Meu amor ""] [" Meu amor ""] [" Meu amor ""] [" Meu amor ""] [" Meu amor ""] [" Meu amor ""] [" Meu amor ""] [" Meu amor ""] [" Meu amor ""] [" Meu amor ""] [" Meu amor ""] [" Meu amor ""] [" Meu amor ""] [" Meu amor ""] [" Meu amor ""] [" Meu amor ""] [	0.18084868148773522
hoitro dia hia a fazer huma vizita achandone eu la tambem i foi a minha prima a porta i dice que não estava sua mai em caza	Outro dia, ia a fazer uma visita, achando-me eu lá também, e foi a minha prima à porta e disse que não estava sua mãe em casa.	"" O dia que eu vou fazer uma visita "" — "" Oh, oh, oh, oh, oh, oh, oh, oh, oh, oh, oh, oh, oh, oh, oh, oh, oh, oh, oh, oh, oh, oh, oh, oh, oh, oh, oh, oh, oh, oh, oh, oh, oh, oh, oh, oh, oh, oh, oh, oh, oh, oh, oh, oh, oh, oh, oh, oh, oh, oh, oh, oh, oh, oh, oh, oh, oh, oh, oh, oh, oh, oh, oh, oh, oh, oh, oh, oh, oh, oh, oh, oh, oh, oh, oh, oh, oh, oh, oh, oh, oh, oh, oh, oh, oh, oh, oh, oh, oh, oh, oh,	0.8859739806001389
i tem tudo fichado para mor dle porque heile hera hum tollo	E tem tudo fechado para mor dele, porque ele era um tolo.	"" Tuve tudo para mor dle "" porque "" Heile hera hum tollo "".	5.0912128230977505
the u forei Antonio ja não vinha caza dela para mor dele	Até o Frei António já não vinha casa dela para mor dele.	"" Eu fori Antonio, "" Já fui atrás de ela "" para mor dele.	12.673718536830808
com isto não emfado mais	Com isto não enfado mais.	"" I'm not into this anymore.	5.522397783539471
desta Sua umilde criada que mto lhe cer i dezeja a vida athe a morte	Desta sua humilde criada que muito lhe quer e deseja a vida até à morte,	Esta émile que eu criei lhe die a vida a morte.	6.1024055573984235
Maria Françisca	Maria Francisca	Maria Francisca.	55.03212081491043


Final score:	{'score': 6.789180939186999, 'counts': [1225, 451, 190, 73], 'totals': [4581, 4434, 4287, 4142], 'precisions': [26.7408862693735, 10.171402796571945, 4.432003732213669, 1.7624336069531628], 'bp': 1.0, 'sys_len': 4581, 'ref_len': 2936}